6,4,4,4,4,4,4,4,4,4,4,4,5
3,1,1,1,0,0,0,1,1,1,1,1,3
3,1,2,1,3,4,3,1,2,1,1,1,3
3,1,1,1,3,0,3,1,1,1,0,1,3
3,0,0,0,3,0,3,0,0,0,0,1,3
3,1,1,1,3,4,3,1,1,1,1,1,3
6,4,4,4,4,4,4,4,4,4,4,4,8
